11111111111111
1E00C000C00C01
100010010C00C1
100C000C000101
1C000P000C0001
11111111111111