111111111111
1E00000000C1
1000CC0010C1
10PC0C0101C1
111111111111